Key	Content
ARM_LLWEAPONEX_Hat_Bicorne_A_1_DisplayName	Captain's Bicorne
ARM_LLWEAPONEX_Hat_Bicorne_A_2_DisplayName	Pirate's Bicorne
ARM_LLWEAPONEX_Hat_Bicorne_A_3_DisplayName	Bicorne of Booty Bay
ARM_LLWEAPONEX_Hat_Bicorne_A_4_DisplayName	Bicorne of the Seas
ARM_LLWEAPONEX_Pistol_A_Crafted_DisplayName	Flintlock Pistol
ARM_LLWEAPONEX_Pistol_A_Common_DisplayName	Old Flintlock Pistol
ARM_LLWEAPONEX_Pistol_A_Uncommon_1_DisplayName	Exquisite Flintlock Pistol
ARM_LLWEAPONEX_Pistol_A_Uncommon_2_DisplayName	Polished Flintlock Pistol
ARM_LLWEAPONEX_Pistol_A_Uncommon_3_DisplayName	Trusty Flintlock Pistol
ARM_LLWEAPONEX_Pistol_A_Uncommon_4_DisplayName	Tuned Flintlock Pistol
ARM_LLWEAPONEX_Pistol_A_Uncommon_5_DisplayName	Brigand's Flintlock Pistol
ARM_LLWEAPONEX_Pistol_A_Rare_1_DisplayName	Speedy Solution
ARM_LLWEAPONEX_Pistol_A_Rare_2_DisplayName	Captain's Inspiration
ARM_LLWEAPONEX_Pistol_A_Rare_3_DisplayName	Pirate's Wit
ARM_LLWEAPONEX_Pistol_A_Epic_1_DisplayName	Glorious Handcannon
ARM_LLWEAPONEX_Pistol_A_Epic_2_DisplayName	Dwarven Peacekeeper
ARM_LLWEAPONEX_Pistol_A_Epic_3_DisplayName	Blackpowder
ARM_LLWEAPONEX_Pistol_A_Legendary_DisplayName	Blackbeard's Reign
ARM_LLWEAPONEX_Pistol_A_Divine_DisplayName	Divine Peacekeeper
ARM_UNIQUE_LLWEAPONEX_ArmCannon_A_DisplayName	Runic Cannon
ARM_UNIQUE_LLWEAPONEX_Backpack_Demolition_A_DisplayName	Demolitionist's Backpack
ARM_UNIQUE_LLWEAPONEX_Blindfold_DisplayName	Demon Hunter's Oath
ARM_UNIQUE_LLWEAPONEX_DemonGauntlet_A_DisplayName	Devil Hand
ARM_UNIQUE_LLWEAPONEX_DragonBoneClaws_A_DisplayName	Dragon Bone Claws
ARM_UNIQUE_LLWEAPONEX_HandCrossbow_A_1_DisplayName	Mini-Arbalest
ARM_UNIQUE_LLWEAPONEX_HandCrossbow_A_2_DisplayName	Magical Mini-Arbalest
ARM_UNIQUE_LLWEAPONEX_Mask_Tengu_A_DisplayName	Tengu Mask
ARM_UNIQUE_LLWEAPONEX_OniGauntlet_A_1_DisplayName	Oni Gauntlet
ARM_UNIQUE_LLWEAPONEX_OniGauntlet_A_2_DisplayName	Oni Gauntlet (Empowered)
ARM_UNIQUE_LLWEAPONEX_OniGauntlet_A_3_DisplayName	Oni Gauntlet (Unleashed)
ARM_UNIQUE_LLWEAPONEX_Ring_GenderSwapper_DisplayName	Ring of the Two Faces
ARM_UNIQUE_LLWEAPONEX_Ring_WeaponMaster_DisplayName	Ring of the Weaponmaster
ARM_UNIQUE_LLWEAPONEX_Ring_WeaponMaster_Description	A ring made to defy the gods.
ARM_UNIQUE_LLWEAPONEX_Tattoos_Magic_Upperbody_A_DisplayName	<font color='#FF4400'>Tattoos of Godly Strength (Unleashed)</font>
ARM_UNIQUE_LLWEAPONEX_Tattoos_Normal_Upperbody_A_DisplayName	Tattoos of Godly Strength
LLWEAPONEX_DragonSlayer_Armour_1_DisplayName	Dragonslayer Mail
LLWEAPONEX_DragonSlayer_Armour_2_DisplayName	Mighty Dragonslayer Mail
LLWEAPONEX_DragonSlayer_Boots_1_DisplayName	Dragonslayer Boots
LLWEAPONEX_DragonSlayer_Boots_2_DisplayName	Mighty Dragonslayer Boots
LLWEAPONEX_DragonSlayer_Gloves_1_DisplayName	Dragonslayer Gloves
LLWEAPONEX_DragonSlayer_Gloves_2_DisplayName	Mighty Dragonslayer Gloves
LLWEAPONEX_DragonSlayer_Helmet_1_DisplayName	Dragonslayer Helmet
LLWEAPONEX_DragonSlayer_Helmet_2_DisplayName	Mighty Dragonslayer Helmet
LLWEAPONEX_DragonSlayer_Pants_1_DisplayName	Dragonslayer Pants
LLWEAPONEX_DragonSlayer_Pants_2_DisplayName	Mighty Dragonslayer Pants
LLWEAPONEX_Quivers_Common_1_DisplayName	Quiver
LLWEAPONEX_Quivers_Common_2_DisplayName	Archer's Quiver
LLWEAPONEX_Quivers_Common_3_DisplayName	Bandit's Quiver
LLWEAPONEX_Quivers_Common_4_DisplayName	Highwayman's Quiver
LLWEAPONEX_Quivers_Common_5_DisplayName	Trusty Quiver
LLWEAPONEX_Quivers_DrawArrow_Common_1_DisplayName	Quickdraw Quiver
LLWEAPONEX_Quivers_DrawArrow_Common_1_Description	A handmade quiver, designed for quickly drawing arrows.<br><font color='#81ab00'>Quickdraw quivers recharge automatically outside of combat.</font>
LLWEAPONEX_Quivers_DrawArrow_Common_2_DisplayName	Flexible Quickdraw Quiver
LLWEAPONEX_Quivers_DrawArrow_Common_2_Description	A handmade quiver, designed for quickly drawing arrows. Once owned by an archer named 'Trusy Nick', who was said to always carry a variety of arrows.<br><font color='#81ab00'>Quickdraw quivers recharge automatically outside of combat.</font>
LLWEAPONEX_Quivers_DrawArrow_Epic_DisplayName	Trusy Nick's Quickdraw Quiver
LLWEAPONEX_Quivers_DrawArrow_Epic_Description	A handmade quiver, designed for quickly drawing arrows. Once owned by an archer named 'Trusy Nick', who was said to always carry a variety of arrows.<br><font color='#81ab00'>Quickdraw quivers recharge automatically outside of combat.</font>
LLWEAPONEX_Quivers_DrawArrow_Rare_1_DisplayName	Exquisite Quickdraw Quiver
LLWEAPONEX_Quivers_DrawArrow_Rare_1_Description	A handmade quiver, designed for quickly drawing arrows. Once owned by an archer named 'Trusy Nick', who was said to always carry a variety of arrows.<br><font color='#81ab00'>Quickdraw quivers recharge automatically outside of combat.</font>
LLWEAPONEX_Quivers_DrawArrow_Rare_2_DisplayName	Speedy Quickdraw Quiver
LLWEAPONEX_Quivers_DrawArrow_Rare_2_Description	A handmade quiver, designed for quickly drawing arrows. Once owned by an archer named 'Trusy Nick', who was said to always carry a variety of arrows.<br><font color='#81ab00'>Quickdraw quivers recharge automatically outside of combat.</font>
LLWEAPONEX_Quivers_DrawArrow_Rare_3_DisplayName	Ancient Elven Quickdraw Quiver
LLWEAPONEX_Quivers_DrawArrow_Rare_3_Description	A handmade quiver, designed for quickly drawing arrows. Once owned by an archer named 'Trusy Nick', who was said to always carry a variety of arrows.<br><font color='#81ab00'>Quickdraw quivers recharge automatically outside of combat.</font>
LLWEAPONEX_Quivers_Epic_1_DisplayName	Legendary Quiver
LLWEAPONEX_Quivers_Epic_2_DisplayName	Eagle Eye Quiver
LLWEAPONEX_Quivers_Epic_3_DisplayName	Quiver of the Hooded Hero
LLWEAPONEX_Quivers_Rare_1_DisplayName	Exquisite Quiver
LLWEAPONEX_Quivers_Rare_2_DisplayName	Mighty Quiver
LLWEAPONEX_Quivers_Rare_3_DisplayName	Ancient Elven Quiver
LLWEAPONEX_RunicKnight_Armour_1_DisplayName	Runic Armour
LLWEAPONEX_RunicKnight_Armour_2_DisplayName	Empowered Runic Armour
LLWEAPONEX_RunicKnight_Boots_1_DisplayName	Runic Boots
LLWEAPONEX_RunicKnight_Boots_2_DisplayName	Empowered Runic Boots
LLWEAPONEX_RunicKnight_Gloves_1_DisplayName	Runic Gloves
LLWEAPONEX_RunicKnight_Gloves_2_DisplayName	Empowered Runic Gloves
LLWEAPONEX_RunicKnight_Helmet_1_DisplayName	Runeweave Hood
LLWEAPONEX_RunicKnight_Helmet_2_DisplayName	Empowered Runeweave Hood
LLWEAPONEX_RunicKnight_Pants_1_DisplayName	Runic Leg Armor
LLWEAPONEX_RunicKnight_Pants_2_DisplayName	Empowered Runic Leg Armor
WPN_LLWEAPONEX_BattleBook_1_DisplayName	Heavy Book
WPN_LLWEAPONEX_BattleBook_2_DisplayName	Weighty Book
WPN_LLWEAPONEX_BattleBook_3_DisplayName	Dictionary
WPN_LLWEAPONEX_BattleBook_4_DisplayName	Scholar's Lecture
WPN_LLWEAPONEX_BattleBook_5_DisplayName	Philosopher's Lesson
WPN_LLWEAPONEX_BattleBook_6_DisplayName	Knowledge Dispenser
WPN_LLWEAPONEX_BattleBook_A_1_DisplayName	Heavy Book
WPN_LLWEAPONEX_BattleBook_A_2_DisplayName	Dusty Book
WPN_LLWEAPONEX_BattleBook_A_3_DisplayName	Scholar's Lecture
WPN_LLWEAPONEX_BattleBook_B_1_DisplayName	Dusty Book
WPN_LLWEAPONEX_BattleBook_B_2_DisplayName	Weighty Book
WPN_LLWEAPONEX_BattleBook_B_3_DisplayName	Philosopher's Lesson
WPN_LLWEAPONEX_BattleBook_C_1_DisplayName	Dusty Book
WPN_LLWEAPONEX_BattleBook_C_2_DisplayName	Weighty Book
WPN_LLWEAPONEX_BattleBook_C_3_DisplayName	Reader's Digest: Combat Edition
WPN_LLWEAPONEX_BattleBook_C_3_Description	Now you'll truly never miss your programs.
WPN_LLWEAPONEX_BattleBook_D_1_DisplayName	Dusty Manual
WPN_LLWEAPONEX_BattleBook_D_2_DisplayName	Action Manual
WPN_LLWEAPONEX_BattleBook_D_3_DisplayName	General Ford's Manual for Tactical Warfare
WPN_LLWEAPONEX_BattleBook_D_3_Description	'Perfect for peppering your enemies with K.N.O.W.L.E.D.G.E.'
WPN_LLWEAPONEX_BattleBook_E_1_DisplayName	Dusty Book
WPN_LLWEAPONEX_BattleBook_E_2_DisplayName	Weighty Book
WPN_LLWEAPONEX_BattleBook_E_3_DisplayName	Combat for Dummies
WPN_LLWEAPONEX_BattleBook_E_3_Description	If knowledge is power, a book can conquer the world.
WPN_LLWEAPONEX_BattleBook_F_1_DisplayName	Dusty Book
WPN_LLWEAPONEX_BattleBook_F_2_DisplayName	Weighty Book
WPN_LLWEAPONEX_BattleBook_F_3_DisplayName	Book of Impartation
WPN_LLWEAPONEX_BattleBook_F_3_Description	Imparts knowledge with a heft 'SMACK!'.
WPN_LLWEAPONEX_Beginner_Rod_DisplayName	Weak Rod
WPN_LLWEAPONEX_Bokken_1H_Crafted_DisplayName	Bokuto
WPN_LLWEAPONEX_Bokken_1H_Epic_1_DisplayName	Mercy
WPN_LLWEAPONEX_Bokken_1H_Epic_2_DisplayName	Blunt Force
WPN_LLWEAPONEX_Bokken_1H_Epic_3_DisplayName	Pacifist's Will
WPN_LLWEAPONEX_Bokken_1H_Epic_4_DisplayName	Legend
WPN_LLWEAPONEX_Bokken_1H_Epic_5_DisplayName	Wooden Destiny
WPN_LLWEAPONEX_Bokken_1H_Normal_1_DisplayName	Old Bokuto
WPN_LLWEAPONEX_Bokken_1H_Normal_2_DisplayName	Traineee's Bokuto
WPN_LLWEAPONEX_Bokken_1H_Normal_3_DisplayName	The Tutor
WPN_LLWEAPONEX_Bokken_1H_Normal_4_DisplayName	Ancient Bokuto
WPN_LLWEAPONEX_Bokken_1H_Normal_5_DisplayName	Bokuto of the Elder Tree
WPN_LLWEAPONEX_Bokken_1H_Preview_DisplayName	Bokuto
WPN_LLWEAPONEX_Bokken_1H_Rare_1_DisplayName	Magicwood Bokuto
WPN_LLWEAPONEX_Bokken_1H_Rare_2_DisplayName	Ancestral Bokuto
WPN_LLWEAPONEX_Bokken_2H_Crafted_DisplayName	Two-handed Bokuto
WPN_LLWEAPONEX_Bokken_2H_Epic_1_DisplayName	Mercy
WPN_LLWEAPONEX_Bokken_2H_Epic_2_DisplayName	Blunt Force
WPN_LLWEAPONEX_Bokken_2H_Epic_3_DisplayName	Pacifist's Will
WPN_LLWEAPONEX_Bokken_2H_Epic_4_DisplayName	Legend
WPN_LLWEAPONEX_Bokken_2H_Epic_5_DisplayName	Wooden Destiny
WPN_LLWEAPONEX_Bokken_2H_Normal_1_DisplayName	Old Two-handed Bokuto
WPN_LLWEAPONEX_Bokken_2H_Normal_2_DisplayName	Traineee's Two-handed Bokuto
WPN_LLWEAPONEX_Bokken_2H_Normal_3_DisplayName	The Tutor
WPN_LLWEAPONEX_Bokken_2H_Normal_4_DisplayName	Ancient Two-handed Bokuto
WPN_LLWEAPONEX_Bokken_2H_Normal_5_DisplayName	Elder's Two-handed Bokuto
WPN_LLWEAPONEX_Bokken_2H_Preview_DisplayName	Two-handed Bokuto
WPN_LLWEAPONEX_Bokken_2H_Rare_1_DisplayName	Magicwood Two-handed Bokuto
WPN_LLWEAPONEX_Bokken_2H_Rare_2_DisplayName	Ancestral Two-handed Bokuto
WPN_LLWEAPONEX_CraftedGreatbow_Dwarves_A_DisplayName	Dwarven Greatbow
WPN_LLWEAPONEX_CraftedGreatbow_Dwarves_B_DisplayName	Exquisite Dwarven Greatbow
WPN_LLWEAPONEX_CraftedGreatbow_Elves_B_DisplayName	Elven Greatbow
WPN_LLWEAPONEX_CraftedGreatbow_Humans_B_DisplayName	Common Greatbow
WPN_LLWEAPONEX_CraftedGreatbow_Lizards_A_DisplayName	Greatbow of the Empire
WPN_LLWEAPONEX_CraftedGreatbow_Lizards_B_DisplayName	Exquisite Greatbow of the Empire
WPN_LLWEAPONEX_CraftedRod_Chaos_DisplayName	Makeshift Chaotic Rod
WPN_LLWEAPONEX_DualShields_Blackring_A_Common_DisplayName	Dual Shields of Chaos
WPN_LLWEAPONEX_DualShields_Blackring_A_Uncommon_1_DisplayName	Exquisite Shields of Chaos
WPN_LLWEAPONEX_DualShields_Blackring_A_Uncommon_2_DisplayName	Sacrificial Shields of Chaos
WPN_LLWEAPONEX_DualShields_Blackring_A_Uncommon_3_DisplayName	Reinforced Chaotic Shields
WPN_LLWEAPONEX_DualShields_Blackring_A_Uncommon_4_DisplayName	Wicked Shields of Chaos
WPN_LLWEAPONEX_DualShields_Blackring_A_Uncommon_5_DisplayName	Bloody Shields of Chaos
WPN_LLWEAPONEX_DualShields_Blackring_A_Rare_1_DisplayName	Chaos Unbound
WPN_LLWEAPONEX_DualShields_Blackring_A_Rare_2_DisplayName	Chaotic Walls of the Black Ring
WPN_LLWEAPONEX_DualShields_Blackring_A_Rare_3_DisplayName	Hope's End, Evil's Foothold
WPN_LLWEAPONEX_DualShields_Blackring_A_Epic_1_DisplayName	Twin Faces of Evil
WPN_LLWEAPONEX_DualShields_Blackring_A_Epic_2_DisplayName	Undying Chaos, Lord's Spire
WPN_LLWEAPONEX_DualShields_Blackring_A_Epic_3_DisplayName	Wall of Chaos, Evil's Reign
WPN_LLWEAPONEX_DualShields_Blackring_A_Legendary_DisplayName	Malice & Destruction
WPN_LLWEAPONEX_DualShields_Blackring_A_Divine_DisplayName	Chaos & Sin, Dark Lord's Calling
WPN_LLWEAPONEX_DualShields_Common_DisplayName	Dual Shields
WPN_LLWEAPONEX_DualShields_Dwarves_A_Common_DisplayName	Dual Dwarven Shields
WPN_LLWEAPONEX_DualShields_Dwarves_A_Uncommon_1_DisplayName	Ancient Dwarven Shields
WPN_LLWEAPONEX_DualShields_Dwarves_A_Uncommon_2_DisplayName	Sturdy Dwarven Shields
WPN_LLWEAPONEX_DualShields_Dwarves_A_Uncommon_3_DisplayName	Reinforced Dwarven Shields
WPN_LLWEAPONEX_DualShields_Dwarves_A_Uncommon_4_DisplayName	Earthen Dwarven Shields
WPN_LLWEAPONEX_DualShields_Dwarves_A_Divine_DisplayName	Plates of Rivellon
WPN_LLWEAPONEX_DualShields_Dwarves_A_Epic_1_DisplayName	Alphaguard, Wolf's Bite
WPN_LLWEAPONEX_DualShields_Dwarves_A_Epic_2_DisplayName	Ancestor's Protection, Enemy's Bane
WPN_LLWEAPONEX_DualShields_Dwarves_A_Epic_3_DisplayName	Dwarvenguard, Wolfbane
WPN_LLWEAPONEX_DualShields_Dwarves_A_Legendary_DisplayName	Oathkeeper, Earthcracker
WPN_LLWEAPONEX_DualShields_Dwarves_A_Rare_1_DisplayName	Exquisite Dwarven Shields
WPN_LLWEAPONEX_DualShields_Dwarves_A_Rare_2_DisplayName	Ancestry Unbound, Dwarven Might
WPN_LLWEAPONEX_DualShields_Dwarves_A_Rare_3_DisplayName	Honor & Duty
WPN_LLWEAPONEX_DualShields_Elves_B_Common_DisplayName	Dual Elven Shields
WPN_LLWEAPONEX_DualShields_Elves_B_Uncommon_1_DisplayName	Exquisite Elven Shields
WPN_LLWEAPONEX_DualShields_Elves_B_Uncommon_2_DisplayName	Finely Crafted Elven Shields
WPN_LLWEAPONEX_DualShields_Elves_B_Uncommon_3_DisplayName	Reinforced Elven Shields
WPN_LLWEAPONEX_DualShields_Elves_B_Uncommon_4_DisplayName	Priceless Elven Shields
WPN_LLWEAPONEX_DualShields_Elves_B_Divine_DisplayName	Vineguard, Cradle of the Divine
WPN_LLWEAPONEX_DualShields_Elves_B_Epic_1_DisplayName	Twin Guards of the Elder Tree
WPN_LLWEAPONEX_DualShields_Elves_B_Epic_2_DisplayName	Poisonwall, Seeker's Bane
WPN_LLWEAPONEX_DualShields_Elves_B_Epic_3_DisplayName	Forestguard, Elderwall
WPN_LLWEAPONEX_DualShields_Elves_B_Legendary_DisplayName	Elderguard, Wrath
WPN_LLWEAPONEX_DualShields_Elves_B_Rare_1_DisplayName	Nature's Guard, Nature's Might
WPN_LLWEAPONEX_DualShields_Elves_B_Rare_2_DisplayName	Guardian of the Immortal
WPN_LLWEAPONEX_DualShields_Elves_B_Rare_3_DisplayName	Forest's Wall, Seeker's Spurn
WPN_LLWEAPONEX_DualShields_Lizards_C_Divine_DisplayName	Selene & Helios, Defenders of the Divine
WPN_LLWEAPONEX_DualShields_Lizards_C_Epic_1_DisplayName	Divine Gates of the Sun
WPN_LLWEAPONEX_DualShields_Lizards_C_Epic_2_DisplayName	Iron Will, Lion's Courage
WPN_LLWEAPONEX_DualShields_Lizards_C_Epic_3_DisplayName	Silver Moon, Golden Sun
WPN_LLWEAPONEX_DualShields_Lizards_C_Legendary_DisplayName	Lunaris & Solaris
WPN_LLWEAPONEX_DualShields_Lizards_C_Rare_1_DisplayName	The Emperor's Wall
WPN_LLWEAPONEX_DualShields_Lizards_C_Rare_2_DisplayName	Barricade of the Ancient Empire
WPN_LLWEAPONEX_DualShields_Lizards_C_Rare_3_DisplayName	Unyielding Walls of the Empire
WPN_LLWEAPONEX_DualShields_Uncommon_1_DisplayName	Ancient Dual Shields
WPN_LLWEAPONEX_DualShields_Uncommon_2_DisplayName	Battle-Hardened Dual Shields
WPN_LLWEAPONEX_DualShields_Uncommon_3_DisplayName	Reinforced Dual Shields
WPN_LLWEAPONEX_DualShields_Uncommon_4_DisplayName	Exquisite Dual Shields
WPN_LLWEAPONEX_DualShields_Uncommon_5_DisplayName	Exceptional Dual Shields
WPN_LLWEAPONEX_DualShields_Uncommon_6_DisplayName	Artisan Dual Shields
WPN_LLWEAPONEX_DualShields_Wooden_A_Common_DisplayName	Dual Wooden Shields
WPN_LLWEAPONEX_DualShields_Wooden_A_Uncommon_1_DisplayName	Lacquered Wooden Shields
WPN_LLWEAPONEX_DualShields_Wooden_A_Uncommon_2_DisplayName	Solid Wooden Shields
WPN_LLWEAPONEX_DualShields_Wooden_A_Uncommon_3_DisplayName	Reinforced Wooden Shields
WPN_LLWEAPONEX_DualShields_Wooden_A_Uncommon_4_DisplayName	Magic-Resistant Wooden Shields
WPN_LLWEAPONEX_DualShields_Wooden_A_Divine_DisplayName	Oaken Aegis, Shield of the Divine
WPN_LLWEAPONEX_DualShields_Wooden_A_Epic_1_DisplayName	Thunderguard
WPN_LLWEAPONEX_DualShields_Wooden_A_Epic_2_DisplayName	Lightningwall
WPN_LLWEAPONEX_DualShields_Wooden_A_Epic_3_DisplayName	Oakenguard, Thunder's Bane
WPN_LLWEAPONEX_DualShields_Wooden_A_Legendary_DisplayName	Oakenwall, Heavenbreaker
WPN_LLWEAPONEX_DualShields_Wooden_A_Rare_1_DisplayName	Oaken Walls
WPN_LLWEAPONEX_DualShields_Wooden_A_Rare_2_DisplayName	Lightning Barrier
WPN_LLWEAPONEX_DualShields_Wooden_A_Rare_3_DisplayName	Lightningbreaker
WPN_LLWEAPONEX_Firearm_2H_Rifle_A_Common_DisplayName	Old Rifle
WPN_LLWEAPONEX_Firearm_2H_Rifle_A_Uncommon_1_DisplayName	Trusty Rifle
WPN_LLWEAPONEX_Firearm_2H_Rifle_A_Uncommon_2_DisplayName	Polished Rifle
WPN_LLWEAPONEX_Firearm_2H_Rifle_A_Uncommon_3_DisplayName	Tuned Rifle
WPN_LLWEAPONEX_Firearm_2H_Rifle_A_Uncommon_4_DisplayName	Well-Balanced Rifle
WPN_LLWEAPONEX_Firearm_2H_Rifle_A_Rare_1_DisplayName	Leadslinger
WPN_LLWEAPONEX_Firearm_2H_Rifle_A_Rare_2_DisplayName	Old Faithful
WPN_LLWEAPONEX_Firearm_2H_Rifle_A_Rare_3_DisplayName	Marksman's Rifle
WPN_LLWEAPONEX_Firearm_2H_Rifle_A_Epic_1_DisplayName	Assassin's Retirement
WPN_LLWEAPONEX_Firearm_2H_Rifle_A_Epic_2_DisplayName	Peasant's Equalizer
WPN_LLWEAPONEX_Firearm_2H_Rifle_A_Epic_3_DisplayName	Sniper's Vow
WPN_LLWEAPONEX_Firearm_2H_Rifle_A_Legendary_DisplayName	Fateslayer
WPN_LLWEAPONEX_Firearm_2H_Rifle_A_Divine_DisplayName	Revolution
WPN_LLWEAPONEX_Firearm_2H_Rifle_A_Crafted_DisplayName	Soldier's Rifle
WPN_LLWEAPONEX_Firearm_2H_Rifle_B_Common_DisplayName	Old Rifle
WPN_LLWEAPONEX_Firearm_2H_Rifle_B_Uncommon_1_DisplayName	Trusty Rifle
WPN_LLWEAPONEX_Firearm_2H_Rifle_B_Uncommon_2_DisplayName	Polished Rifle
WPN_LLWEAPONEX_Firearm_2H_Rifle_B_Uncommon_3_DisplayName	Tuned Rifle
WPN_LLWEAPONEX_Firearm_2H_Rifle_B_Uncommon_4_DisplayName	Well-Balanced Rifle
WPN_LLWEAPONEX_Firearm_2H_Rifle_B_Rare_1_DisplayName	Leadslinger
WPN_LLWEAPONEX_Firearm_2H_Rifle_B_Rare_2_DisplayName	Old Faithful
WPN_LLWEAPONEX_Firearm_2H_Rifle_B_Rare_3_DisplayName	Marksman's Rifle
WPN_LLWEAPONEX_Firearm_2H_Rifle_B_Epic_1_DisplayName	Assassin's Retirement
WPN_LLWEAPONEX_Firearm_2H_Rifle_B_Epic_2_DisplayName	Peasant's Equalizer
WPN_LLWEAPONEX_Firearm_2H_Rifle_B_Epic_3_DisplayName	Sniper's Vow
WPN_LLWEAPONEX_Firearm_2H_Rifle_B_Legendary_DisplayName	Fateslayer
WPN_LLWEAPONEX_Firearm_2H_Rifle_B_Divine_DisplayName	Revolution
WPN_LLWEAPONEX_Firearm_2H_Rifle_B_Crafted_DisplayName	Sniper's Rifle
WPN_LLWEAPONEX_Glaive_2H_Crafted_1_DisplayName	Crafted Glaive
WPN_LLWEAPONEX_Glaive_2H_Crafted_2_DisplayName	Artisan's Glaive
WPN_LLWEAPONEX_Glaive_2H_Crafted_3_DisplayName	Glaive
WPN_LLWEAPONEX_Glaive_2H_Epic_1_DisplayName	General's Mercy
WPN_LLWEAPONEX_Glaive_2H_Epic_2_DisplayName	Night's Edge
WPN_LLWEAPONEX_Glaive_2H_Epic_3_DisplayName	Widowmaker
WPN_LLWEAPONEX_Glaive_2H_Epic_4_DisplayName	Peacekeeper
WPN_LLWEAPONEX_Glaive_2H_Epic_5_DisplayName	Remorse
WPN_LLWEAPONEX_Glaive_2H_Epic_6_DisplayName	Extermination
WPN_LLWEAPONEX_Glaive_2H_Epic_7_DisplayName	Skirmisher
WPN_LLWEAPONEX_Glaive_2H_Epic_8_DisplayName	Neck Relief
WPN_LLWEAPONEX_Glaive_2H_Epic_9_DisplayName	Executioner's Promise
WPN_LLWEAPONEX_Glaive_2H_Epic_10_DisplayName	Execution
WPN_LLWEAPONEX_Glaive_2H_Epic_11_DisplayName	Etcher of Desecration
WPN_LLWEAPONEX_Glaive_2H_Epic_12_DisplayName	Unholy Razor
WPN_LLWEAPONEX_Glaive_2H_Epic_13_DisplayName	Stormrider
WPN_LLWEAPONEX_Glaive_2H_Epic_14_DisplayName	Nightfall
WPN_LLWEAPONEX_Glaive_2H_Epic_15_DisplayName	Blinder
WPN_LLWEAPONEX_Glaive_2H_Epic_16_DisplayName	Soulcursed Ebon Skewer
WPN_LLWEAPONEX_Glaive_2H_Normal_1_DisplayName	Glaive
WPN_LLWEAPONEX_Glaive_2H_Normal_2_DisplayName	Honed Glaive
WPN_LLWEAPONEX_Glaive_2H_Normal_3_DisplayName	Magical Glaive
WPN_LLWEAPONEX_Glaive_2H_Rare_1_DisplayName	Reinforced Glaive
WPN_LLWEAPONEX_Glaive_2H_Rare_2_DisplayName	Steel Glaive
WPN_LLWEAPONEX_Glaive_2H_Rare_3_DisplayName	Battleworn Glaive
WPN_LLWEAPONEX_Glaive_2H_Rare_4_DisplayName	Soldier's Glaive
WPN_LLWEAPONEX_Glaive_2H_Weak_1_DisplayName	Worn Glaive
WPN_LLWEAPONEX_Glaive_2H_Weak_2_DisplayName	Chipped Glaive
WPN_LLWEAPONEX_Greatbow_Crafted_1_DisplayName	Trusty Old Greatbow
WPN_LLWEAPONEX_Greatbow_Crafted_1_Description	An old greatbow passed down as a family heirloom. Not the strongest, but it'll do.
WPN_LLWEAPONEX_Greatbow_Crafted_2_DisplayName	Greatbow
WPN_LLWEAPONEX_Greatbow_Crafted_3_DisplayName	Artisan Greatbow
WPN_LLWEAPONEX_Greatbow_Normal_1_DisplayName	Hunter's Greatbow
WPN_LLWEAPONEX_Greatbow_Normal_2_DisplayName	Strongman's Greatbow
WPN_LLWEAPONEX_Greatbow_Normal_3_DisplayName	Warrior's Greatbow
WPN_LLWEAPONEX_Greatbow_Normal_4_DisplayName	Dragonslayer's Greatbow
WPN_LLWEAPONEX_Greatbow_Normal_5_DisplayName	Slayer's Greatbow
WPN_LLWEAPONEX_Greatbow_Normal_6_DisplayName	Mighty Greatbow 
WPN_LLWEAPONEX_Greatbow_Normal_7_DisplayName	Tough Greatbow 
WPN_LLWEAPONEX_Greatbow_Weak_1_DisplayName	Worn Greatbow
WPN_LLWEAPONEX_Greatbow_Weak_2_DisplayName	Old Greatbow
WPN_LLWEAPONEX_Greatbow_Weak_3_DisplayName	Shoddy Greatbow
WPN_LLWEAPONEX_Halberd_2H_Crafted_1_DisplayName	Crafted Halberd
WPN_LLWEAPONEX_Halberd_2H_Crafted_2_DisplayName	Artisan's Halberd
WPN_LLWEAPONEX_Halberd_2H_Crafted_3_DisplayName	Halberd
WPN_LLWEAPONEX_Halberd_2H_Epic_1_DisplayName	General's Mercy
WPN_LLWEAPONEX_Halberd_2H_Epic_2_DisplayName	Night's Edge
WPN_LLWEAPONEX_Halberd_2H_Epic_3_DisplayName	Widowmaker
WPN_LLWEAPONEX_Halberd_2H_Epic_4_DisplayName	Peacekeeper
WPN_LLWEAPONEX_Halberd_2H_Epic_5_DisplayName	Remorse
WPN_LLWEAPONEX_Halberd_2H_Epic_6_DisplayName	Extermination
WPN_LLWEAPONEX_Halberd_2H_Epic_7_DisplayName	Skirmisher
WPN_LLWEAPONEX_Halberd_2H_Epic_8_DisplayName	Neck Relief
WPN_LLWEAPONEX_Halberd_2H_Epic_9_DisplayName	Executioner's Promise
WPN_LLWEAPONEX_Halberd_2H_Epic_10_DisplayName	Execution
WPN_LLWEAPONEX_Halberd_2H_Epic_11_DisplayName	Etcher of Desecration
WPN_LLWEAPONEX_Halberd_2H_Epic_12_DisplayName	Unholy Razor
WPN_LLWEAPONEX_Halberd_2H_Epic_13_DisplayName	Stormrider
WPN_LLWEAPONEX_Halberd_2H_Epic_14_DisplayName	Nightfall
WPN_LLWEAPONEX_Halberd_2H_Epic_15_DisplayName	Blinder
WPN_LLWEAPONEX_Halberd_2H_Epic_16_DisplayName	Soulcursed Ebon Skewer
WPN_LLWEAPONEX_Halberd_2H_Normal_1_DisplayName	Halberd
WPN_LLWEAPONEX_Halberd_2H_Normal_2_DisplayName	Honed Halberd
WPN_LLWEAPONEX_Halberd_2H_Normal_3_DisplayName	Reinforced Halberd
WPN_LLWEAPONEX_Halberd_2H_Rare_1_DisplayName	Deadly Halberd
WPN_LLWEAPONEX_Halberd_2H_Rare_2_DisplayName	Severing Halberd
WPN_LLWEAPONEX_Halberd_2H_Rare_3_DisplayName	Battleworn Halberd
WPN_LLWEAPONEX_Halberd_2H_Rare_4_DisplayName	Soldier's Halberd
WPN_LLWEAPONEX_Halberd_2H_Weak_1_DisplayName	Worn Halberd
WPN_LLWEAPONEX_Halberd_2H_Weak_2_DisplayName	Chipped Halberd
WPN_LLWEAPONEX_HandCrossbow_Crafted_Lizards_A_1_DisplayName	Mini-Arbalest
WPN_LLWEAPONEX_HandCrossbow_Crafted_Lizards_A_2_DisplayName	Magical Mini-Arbalest
WPN_LLWEAPONEX_Improv_Rod_DisplayName	Makeshift Rod
WPN_LLWEAPONEX_Katana_1H_Crafted_DisplayName	Katana
WPN_LLWEAPONEX_Katana_1H_Epic_1_DisplayName	Yamato's Edge
WPN_LLWEAPONEX_Katana_1H_Epic_2_DisplayName	Musashi's Victory
WPN_LLWEAPONEX_Katana_1H_Epic_3_DisplayName	Honor's Edge
WPN_LLWEAPONEX_Katana_1H_Epic_4_DisplayName	Blade of the Warrior
WPN_LLWEAPONEX_Katana_1H_Epic_5_DisplayName	Omnislash
WPN_LLWEAPONEX_Katana_1H_Epic_6_DisplayName	Demon's Blade
WPN_LLWEAPONEX_Katana_1H_Epic_7_DisplayName	Roninslayer
WPN_LLWEAPONEX_Katana_1H_Normal_1_DisplayName	Old Katana
WPN_LLWEAPONEX_Katana_1H_Normal_2_DisplayName	Worn Katana
WPN_LLWEAPONEX_Katana_1H_Normal_3_DisplayName	Katana
WPN_LLWEAPONEX_Katana_1H_Rare_1_DisplayName	Reinforced Katana
WPN_LLWEAPONEX_Katana_1H_Rare_2_DisplayName	Razor-Sharp Katana
WPN_LLWEAPONEX_Katana_1H_Rare_3_DisplayName	Wanderer's Katana
WPN_LLWEAPONEX_Katana_1H_Rare_4_DisplayName	Ronin's Katana
WPN_LLWEAPONEX_Katana_1H_Rare_5_DisplayName	Soldier's Katana
WPN_LLWEAPONEX_Wakizashi_1H_Crafted_DisplayName	Wakizashi
WPN_LLWEAPONEX_Wakizashi_1H_Epic_1_DisplayName	Blade of Regicide
WPN_LLWEAPONEX_Wakizashi_1H_Epic_2_DisplayName	Shinobi Arm
WPN_LLWEAPONEX_Wakizashi_1H_Epic_3_DisplayName	Bladespiral
WPN_LLWEAPONEX_Wakizashi_1H_Epic_4_DisplayName	Shadow Stalker
WPN_LLWEAPONEX_Wakizashi_1H_Epic_5_DisplayName	Kingslayer
WPN_LLWEAPONEX_Wakizashi_1H_Epic_6_DisplayName	Oni Edge
WPN_LLWEAPONEX_Wakizashi_1H_Epic_7_DisplayName	Roninslayer
WPN_LLWEAPONEX_Wakizashi_1H_Normal_1_DisplayName	Old Wakizashi
WPN_LLWEAPONEX_Wakizashi_1H_Normal_2_DisplayName	Worn Wakizashi
WPN_LLWEAPONEX_Wakizashi_1H_Normal_3_DisplayName	Wakizashi
WPN_LLWEAPONEX_Wakizashi_1H_Rare_1_DisplayName	Reinforced Wakizashi
WPN_LLWEAPONEX_Wakizashi_1H_Rare_2_DisplayName	Razor-Sharp Wakizashi
WPN_LLWEAPONEX_Wakizashi_1H_Rare_3_DisplayName	Wanderer's Blade
WPN_LLWEAPONEX_Wakizashi_1H_Rare_4_DisplayName	Ronin's Sidearm
WPN_LLWEAPONEX_Wakizashi_1H_Rare_5_DisplayName	Assassin's Wakizashi
WPN_LLWEAPONEX_Katana_2H_Crafted_DisplayName	Odachi
WPN_LLWEAPONEX_Katana_2H_Normal_1_DisplayName	Old Odachi
WPN_LLWEAPONEX_Katana_2H_Normal_2_DisplayName	Worn Odachi
WPN_LLWEAPONEX_Katana_2H_Normal_3_DisplayName	Odachi
WPN_LLWEAPONEX_Katana_2H_Rare_1_DisplayName	Reinforced Odachi
WPN_LLWEAPONEX_Katana_2H_Rare_2_DisplayName	Steel Odachi
WPN_LLWEAPONEX_Katana_2H_Rare_3_DisplayName	Odachi of the Forsaken
WPN_LLWEAPONEX_Katana_2H_Rare_4_DisplayName	Ronin's Odachi
WPN_LLWEAPONEX_Katana_2H_Rare_5_DisplayName	Soldier's Odachi
WPN_LLWEAPONEX_Katana_2H_Epic_1_DisplayName	Manslayer
WPN_LLWEAPONEX_Katana_2H_Epic_2_DisplayName	Blade of the Silver Slayer
WPN_LLWEAPONEX_Katana_2H_Epic_3_DisplayName	Crescent Blade
WPN_LLWEAPONEX_Katana_2H_Epic_4_DisplayName	Blade of the Fallen Angel
WPN_LLWEAPONEX_Katana_2H_Epic_5_DisplayName	Rend
WPN_LLWEAPONEX_Katana_2H_ShuraSamurai_A_Crafted	Great Odachi
WPN_LLWEAPONEX_Katana_2H_ShuraSamurai_A_Normal_1_DisplayName	Old Great Odachi
WPN_LLWEAPONEX_Katana_2H_ShuraSamurai_A_Normal_2_DisplayName	Worn Great Odachi
WPN_LLWEAPONEX_Katana_2H_ShuraSamurai_A_Normal_3_DisplayName	Great Odachi
WPN_LLWEAPONEX_Katana_2H_ShuraSamurai_A_Rare_1_DisplayName	Reinforced Great Odachi
WPN_LLWEAPONEX_Katana_2H_ShuraSamurai_A_Rare_2_DisplayName	Battleworn Great Odachi
WPN_LLWEAPONEX_Katana_2H_ShuraSamurai_A_Rare_3_DisplayName	Great Odachi of the Mighty
WPN_LLWEAPONEX_Katana_2H_ShuraSamurai_A_Rare_4_DisplayName	Manslayer's Great Odachi
WPN_LLWEAPONEX_Katana_2H_ShuraSamurai_A_Rare_5_DisplayName	Fleshrender, Great Odachi
WPN_LLWEAPONEX_Katana_2H_ShuraSamurai_A_Epic_1_DisplayName	Soulsplitter
WPN_LLWEAPONEX_Katana_2H_ShuraSamurai_A_Epic_2_DisplayName	Murakumo, Great Blade
WPN_LLWEAPONEX_Katana_2H_ShuraSamurai_A_Epic_3_DisplayName	Warlord's Curved Greatsword
WPN_LLWEAPONEX_Katana_2H_ShuraSamurai_A_Epic_4_DisplayName	Shogunite's Judgement
WPN_LLWEAPONEX_Katana_2H_ShuraSamurai_A_Epic_5_DisplayName	Furythrasher
WPN_LLWEAPONEX_Quarterstaff_Epic_1_DisplayName	Pilgrim's Companion
WPN_LLWEAPONEX_Quarterstaff_Epic_2_DisplayName	Legbane
WPN_LLWEAPONEX_Quarterstaff_Epic_3_DisplayName	Equalizer
WPN_LLWEAPONEX_Quarterstaff_Epic_4_DisplayName	Gravity Falls
WPN_LLWEAPONEX_Quarterstaff_Epic_5_DisplayName	Monk's Resolution
WPN_LLWEAPONEX_Quarterstaff_Epic_6_DisplayName	Headcracker
WPN_LLWEAPONEX_Quarterstaff_Metal_Crafted_DisplayName	Metal Pipe
WPN_LLWEAPONEX_Quarterstaff_Normal_Metal_1_DisplayName	Metal Quarterstaff
WPN_LLWEAPONEX_Quarterstaff_Normal_Metal_2_DisplayName	Rusty Metal Quarterstaff
WPN_LLWEAPONEX_Quarterstaff_Normal_Metal_3_DisplayName	Worn Metal Quarterstaff
WPN_LLWEAPONEX_Quarterstaff_Normal_Metal_4_DisplayName	Training Quarterstaff
WPN_LLWEAPONEX_Quarterstaff_Normal_Metal_5_DisplayName	Pilgrim's Quarterstaff
WPN_LLWEAPONEX_Quarterstaff_Normal_Metal_6_DisplayName	Monk's Quarterstaff
WPN_LLWEAPONEX_Quarterstaff_Normal_Metal_7_DisplayName	Acolyte's Quarterstaff
WPN_LLWEAPONEX_Quarterstaff_Normal_Metal_Weak_1_DisplayName	Rusty Pipe
WPN_LLWEAPONEX_Quarterstaff_Normal_Metal_Weak_2_DisplayName	Old Metal Pipe
WPN_LLWEAPONEX_Quarterstaff_Normal_Metal_Weak_3_DisplayName	Dented Metal Pipe
WPN_LLWEAPONEX_Quarterstaff_Normal_Metal_Weak_4_DisplayName	Tough Metal Pipe
WPN_LLWEAPONEX_Quarterstaff_Normal_Wood_1_DisplayName	Old Quarterstaff
WPN_LLWEAPONEX_Quarterstaff_Normal_Wood_2_DisplayName	Worn Quarterstaff
WPN_LLWEAPONEX_Quarterstaff_Normal_Wood_3_DisplayName	Wooden Quarterstaff
WPN_LLWEAPONEX_Quarterstaff_Normal_Wood_4_DisplayName	Walking Stick
WPN_LLWEAPONEX_Quarterstaff_Normal_Wood_5_DisplayName	Pilgrim's Quarterstaff
WPN_LLWEAPONEX_Quarterstaff_Normal_Wood_6_DisplayName	Monk's Quarterstaff
WPN_LLWEAPONEX_Quarterstaff_Normal_Wood_7_DisplayName	Acolyte's Quarterstaff
WPN_LLWEAPONEX_Quarterstaff_Normal_Wood1_DisplayName	Capped Quarterstaff
WPN_LLWEAPONEX_Quarterstaff_Normal_Wood2_DisplayName	Spiked Quarterstaff
WPN_LLWEAPONEX_Quarterstaff_Normal_Wood3_DisplayName	Pilgrim's Spiked Quarterstaff
WPN_LLWEAPONEX_Quarterstaff_Normal_Wood4_DisplayName	Monk's Spiked Quarterstaff
WPN_LLWEAPONEX_Quarterstaff_Normal_Wood5_DisplayName	Journeyman's Spiked Quarterstaff
WPN_LLWEAPONEX_Quarterstaff_Rare_1_DisplayName	Defender's Post
WPN_LLWEAPONEX_Quarterstaff_Rare_2_DisplayName	Tigerstrike
WPN_LLWEAPONEX_Quarterstaff_Rare_3_DisplayName	Reacher
WPN_LLWEAPONEX_Quarterstaff_Rare_4_DisplayName	Trippington
WPN_LLWEAPONEX_Quarterstaff_Rare_5_DisplayName	Sweeper
WPN_LLWEAPONEX_Quarterstaff_Wood_Crafted_DisplayName	Wooden Quarterstaff
WPN_LLWEAPONEX_Rapier_1H_Crafted_1_DisplayName	Rapier
WPN_LLWEAPONEX_Rapier_1H_Crafted_2_DisplayName	Estoc
WPN_LLWEAPONEX_Rapier_1H_Epic_1_DisplayName	Ricard's Piercing Storm
WPN_LLWEAPONEX_Rapier_1H_Epic_2_DisplayName	Heartpiercer
WPN_LLWEAPONEX_Rapier_1H_Epic_3_DisplayName	Gladiator's Victory
WPN_LLWEAPONEX_Rapier_1H_Epic_4_DisplayName	Dancing Steel
WPN_LLWEAPONEX_Rapier_1H_Epic_5_DisplayName	Blade of the Seven-finger Man
WPN_LLWEAPONEX_Rapier_1H_Normal_1_DisplayName	Old Foil
WPN_LLWEAPONEX_Rapier_1H_Normal_2_DisplayName	Worn Estoc
WPN_LLWEAPONEX_Rapier_1H_Normal_3_DisplayName	Worn Rapier
WPN_LLWEAPONEX_Rapier_1H_Normal_4_DisplayName	Gladiator's Estoc
WPN_LLWEAPONEX_Rapier_1H_Normal_5_DisplayName	Fencer's Rapier
WPN_LLWEAPONEX_Rapier_1H_Normal_6_DisplayName	Flaying Foil
WPN_LLWEAPONEX_Rapier_1H_Rare_1_DisplayName	Shredding Rapier
WPN_LLWEAPONEX_Rapier_1H_Rare_2_DisplayName	Eviscerating Estoc
WPN_LLWEAPONEX_Rapier_1H_Rare_3_DisplayName	Estoc of the Champion
WPN_LLWEAPONEX_Rapier_1H_Rare_4_DisplayName	Hero's Estoc
WPN_LLWEAPONEX_Rapier_1H_Rare_5_DisplayName	Champion's Rapier
WPN_LLWEAPONEX_Rod_Human_01_DisplayName	Wooden Rod
WPN_LLWEAPONEX_Rod_Human_02_DisplayName	Stone Rod
WPN_LLWEAPONEX_Rod_Of_Nature_1_DisplayName	Rod Of Nature
WPN_LLWEAPONEX_Rod_Of_Nature_2_DisplayName	Magical Rod Of Nature
WPN_LLWEAPONEX_Rod_Of_The_Dwarf_1_DisplayName	Rod Of The Dwarf
WPN_LLWEAPONEX_Rod_Of_The_Dwarf_2_DisplayName	Magical Rod Of The Dwarf
WPN_LLWEAPONEX_Rod_Of_The_Lizard_1_DisplayName	Rod Of The Lizard
WPN_LLWEAPONEX_Rod_Of_The_Lizard_2_DisplayName	Magical Rod Of The Lizard
WPN_LLWEAPONEX_Rods_1H_Epic_1_DisplayName	Ashwood Branch
WPN_LLWEAPONEX_Rods_1H_Epic_2_DisplayName	Death's Last Stand
WPN_LLWEAPONEX_Rods_1H_Epic_3_DisplayName	Roundwind
WPN_LLWEAPONEX_Rods_1H_Epic_4_DisplayName	Bearwindle
WPN_LLWEAPONEX_Rods_1H_Epic_5_DisplayName	Spinewinder
WPN_LLWEAPONEX_Rods_1H_Epic_6_DisplayName	Kiss Of Death
WPN_LLWEAPONEX_Rods_1H_Rare_1_DisplayName	Nightbane
WPN_LLWEAPONEX_Rods_1H_Rare_2_DisplayName	Grand Scepter
WPN_LLWEAPONEX_Rods_1H_Rare_3_DisplayName	Obliterator
WPN_LLWEAPONEX_Rods_1H_Rare_4_DisplayName	War Cane
WPN_LLWEAPONEX_Rods_1H_Rare_5_DisplayName	The Dag
WPN_LLWEAPONEX_Rods_1H_Rare_6_DisplayName	Blackfinger
WPN_LLWEAPONEX_Rods_1H_Rare_7_DisplayName	The Wyre
WPN_LLWEAPONEX_Rods_1H_Rare_8_DisplayName	Woe Tine
WPN_LLWEAPONEX_Runeblade_1H_Start_DisplayName	Rookie's Runeblade
WPN_LLWEAPONEX_Runeblade_Air_1H_Crafted_DisplayName	Tempered Runeblade of Air
WPN_LLWEAPONEX_Runeblade_Air_1H_Epic_1_DisplayName	Thunderfury
WPN_LLWEAPONEX_Runeblade_Air_1H_Epic_2_DisplayName	Raijin
WPN_LLWEAPONEX_Runeblade_Air_1H_Epic_3_DisplayName	Sparkstorm
WPN_LLWEAPONEX_Runeblade_Air_1H_Epic_4_DisplayName	Odinblade
WPN_LLWEAPONEX_Runeblade_Air_1H_Normal_1_DisplayName	Old Runeblade of Air
WPN_LLWEAPONEX_Runeblade_Air_1H_Normal_2_DisplayName	Worn Runeblade of Air
WPN_LLWEAPONEX_Runeblade_Air_1H_Normal_3_DisplayName	Runeblade of Air
WPN_LLWEAPONEX_Runeblade_Air_1H_Rare_1_DisplayName	Stormblade
WPN_LLWEAPONEX_Runeblade_Air_1H_Rare_2_DisplayName	Cloudstriker
WPN_LLWEAPONEX_Runeblade_Air_1H_Rare_3_DisplayName	Conductor
WPN_LLWEAPONEX_Runeblade_Air_1H_Rare_4_DisplayName	Lightningrod
WPN_LLWEAPONEX_Runeblade_Air_1H_Rare_5_DisplayName	Supercharger
WPN_LLWEAPONEX_Runeblade_Air_1H_Rare_6_DisplayName	Thunderstruck
WPN_LLWEAPONEX_Runeblade_Chaos_1H_Crafted_DisplayName	Tempered Chaotic Runeblade
WPN_LLWEAPONEX_Runeblade_Chaos_1H_Epic_1_DisplayName	Voidwoken Nightmare
WPN_LLWEAPONEX_Runeblade_Chaos_1H_Epic_2_DisplayName	Elementia
WPN_LLWEAPONEX_Runeblade_Chaos_1H_Epic_3_DisplayName	Lucian's Chaos
WPN_LLWEAPONEX_Runeblade_Chaos_1H_Epic_4_DisplayName	Abyssal Gaze
WPN_LLWEAPONEX_Runeblade_Chaos_1H_Epic_5_DisplayName	Chaos Incarnate
WPN_LLWEAPONEX_Runeblade_Chaos_1H_Normal_1_DisplayName	Old Runeblade of Chaos
WPN_LLWEAPONEX_Runeblade_Chaos_1H_Normal_2_DisplayName	Worn Runeblade of Chaos
WPN_LLWEAPONEX_Runeblade_Chaos_1H_Normal_3_DisplayName	Runeblade of Chaos
WPN_LLWEAPONEX_Runeblade_Chaos_1H_Rare_1_DisplayName	Chaosblade
WPN_LLWEAPONEX_Runeblade_Chaos_1H_Rare_2_DisplayName	Spellsponge
WPN_LLWEAPONEX_Runeblade_Chaos_1H_Rare_3_DisplayName	Chaotic Runeslayer
WPN_LLWEAPONEX_Runeblade_Chaos_1H_Rare_4_DisplayName	Voidkin
WPN_LLWEAPONEX_Runeblade_Debug_1H_DisplayName	Debug Runeblade
WPN_LLWEAPONEX_Runeblade_Earth_1H_Crafted_DisplayName	Tempered Runeblade of Earth
WPN_LLWEAPONEX_Runeblade_Earth_1H_Epic_1_DisplayName	Erosion
WPN_LLWEAPONEX_Runeblade_Earth_1H_Epic_2_DisplayName	Planetcracker
WPN_LLWEAPONEX_Runeblade_Earth_1H_Epic_3_DisplayName	Earthbender
WPN_LLWEAPONEX_Runeblade_Earth_1H_Epic_4_DisplayName	Toph's Pride
WPN_LLWEAPONEX_Runeblade_Earth_1H_Epic_5_DisplayName	Quake
WPN_LLWEAPONEX_Runeblade_Earth_1H_Normal_1_DisplayName	Old Runeblade of Earth
WPN_LLWEAPONEX_Runeblade_Earth_1H_Normal_2_DisplayName	Worn Runeblade of Earth
WPN_LLWEAPONEX_Runeblade_Earth_1H_Normal_3_DisplayName	Runeblade of Earth
WPN_LLWEAPONEX_Runeblade_Earth_1H_Rare_1_DisplayName	Boulderblade
WPN_LLWEAPONEX_Runeblade_Earth_1H_Rare_2_DisplayName	Earthenblade
WPN_LLWEAPONEX_Runeblade_Earth_1H_Rare_3_DisplayName	Mountain's Oath
WPN_LLWEAPONEX_Runeblade_Earth_1H_Rare_4_DisplayName	Groundcracker
WPN_LLWEAPONEX_Runeblade_Earth_1H_Rare_5_DisplayName	Tremor
WPN_LLWEAPONEX_Runeblade_Fire_1H_Crafted_DisplayName	Tempered Runeblade of Fire
WPN_LLWEAPONEX_Runeblade_Fire_1H_Epic_1_DisplayName	Soul Scorcher
WPN_LLWEAPONEX_Runeblade_Fire_1H_Epic_2_DisplayName	Agni Ignus
WPN_LLWEAPONEX_Runeblade_Fire_1H_Epic_3_DisplayName	Solardyne
WPN_LLWEAPONEX_Runeblade_Fire_1H_Epic_4_DisplayName	Nuke
WPN_LLWEAPONEX_Runeblade_Fire_1H_Epic_5_DisplayName	Zuko's Fury
WPN_LLWEAPONEX_Runeblade_Fire_1H_Normal_1_DisplayName	Old Runeblade of Fire
WPN_LLWEAPONEX_Runeblade_Fire_1H_Normal_2_DisplayName	Worn Runeblade of Fire
WPN_LLWEAPONEX_Runeblade_Fire_1H_Normal_3_DisplayName	Runeblade of Fire
WPN_LLWEAPONEX_Runeblade_Fire_1H_Rare_1_DisplayName	Incinerator
WPN_LLWEAPONEX_Runeblade_Fire_1H_Rare_2_DisplayName	Ashenblade
WPN_LLWEAPONEX_Runeblade_Fire_1H_Rare_3_DisplayName	Charred Edge
WPN_LLWEAPONEX_Runeblade_Fire_1H_Rare_4_DisplayName	Witch's End
WPN_LLWEAPONEX_Runeblade_Inert_1H_1_DisplayName	Inert Runeblade
WPN_LLWEAPONEX_Runeblade_Inert_1H_2_DisplayName	Ancient Inert Runeblade
WPN_LLWEAPONEX_Runeblade_Inert_1H_3_DisplayName	Old Inert Runeblade
WPN_LLWEAPONEX_Runeblade_Inert_1H_4_DisplayName	Inert Runeblade, Family Heirloom
WPN_LLWEAPONEX_Runeblade_Poison_1H_Crafted_DisplayName	Tempered Runeblade of Poison
WPN_LLWEAPONEX_Runeblade_Poison_1H_Epic_1_DisplayName	Toxic Edge
WPN_LLWEAPONEX_Runeblade_Poison_1H_Epic_2_DisplayName	Spider Queen's Caress
WPN_LLWEAPONEX_Runeblade_Poison_1H_Epic_3_DisplayName	Delphinium
WPN_LLWEAPONEX_Runeblade_Poison_1H_Epic_4_DisplayName	Gravelord's Blade
WPN_LLWEAPONEX_Runeblade_Poison_1H_Epic_5_DisplayName	Deadly Essence
WPN_LLWEAPONEX_Runeblade_Poison_1H_Normal_1_DisplayName	Old Runeblade of Poison
WPN_LLWEAPONEX_Runeblade_Poison_1H_Normal_2_DisplayName	Worn Runeblade of Poison
WPN_LLWEAPONEX_Runeblade_Poison_1H_Normal_3_DisplayName	Runeblade of Poison
WPN_LLWEAPONEX_Runeblade_Poison_1H_Rare_1_DisplayName	Venomblade
WPN_LLWEAPONEX_Runeblade_Poison_1H_Rare_2_DisplayName	Virus
WPN_LLWEAPONEX_Runeblade_Poison_1H_Rare_3_DisplayName	Undead Delight
WPN_LLWEAPONEX_Runeblade_Poison_1H_Rare_4_DisplayName	Sludgeblade
WPN_LLWEAPONEX_Runeblade_Water_1H_Crafted_DisplayName	Tempered Runeblade of Water
WPN_LLWEAPONEX_Runeblade_Water_1H_Epic_1_DisplayName	Frostmourne
WPN_LLWEAPONEX_Runeblade_Water_1H_Epic_2_DisplayName	Subzero Slayer
WPN_LLWEAPONEX_Runeblade_Water_1H_Epic_3_DisplayName	Spring's Bane
WPN_LLWEAPONEX_Runeblade_Water_1H_Epic_4_DisplayName	Cryoblade
WPN_LLWEAPONEX_Runeblade_Water_1H_Epic_5_DisplayName	Katara's Hope
WPN_LLWEAPONEX_Runeblade_Water_1H_Normal_1_DisplayName	Old Runeblade of Water
WPN_LLWEAPONEX_Runeblade_Water_1H_Normal_2_DisplayName	Worn Runeblade of Water
WPN_LLWEAPONEX_Runeblade_Water_1H_Normal_3_DisplayName	Runeblade of Water
WPN_LLWEAPONEX_Runeblade_Water_1H_Rare_1_DisplayName	Permafrost
WPN_LLWEAPONEX_Runeblade_Water_1H_Rare_2_DisplayName	Snowflake's Revenge
WPN_LLWEAPONEX_Runeblade_Water_1H_Rare_3_DisplayName	Cold Calamity
WPN_LLWEAPONEX_Runeblade_Water_1H_Rare_4_DisplayName	Icecrash
WPN_LLWEAPONEX_Runeblade_Water_1H_Rare_5_DisplayName	Chillblade
WPN_LLWEAPONEX_Runeblades_1H_DisplayName	Runeblade
WPN_LLWEAPONEX_Stone_Rod_1_DisplayName	Stone Rod
WPN_LLWEAPONEX_Stone_Rod_2_DisplayName	Magical Stone Rod
WPN_LLWEAPONEX_Unarmed_Fist_DisplayName	Brawler's Fist
WPN_LLWEAPONEX_Unarmed_Fist_Description	The iron-hard fist of a Brawler. Strikes true.
WPN_LLWEAPONEX_Wooden_Rod_1_DisplayName	Wooden Rod
WPN_LLWEAPONEX_Wooden_Rod_2_DisplayName	Magical Wooden Rod
WPN_UNIQUE_LLWEAPONEX_Anvil_Mace_2H_A_DisplayName	Anvilmar, Dwarven Negotiator
WPN_UNIQUE_LLWEAPONEX_ArmCannon_A_DisplayName	Runic Cannon
WPN_UNIQUE_LLWEAPONEX_Axe_1H_Throwable_A_DisplayName	Balrin's Throwing Axe
WPN_UNIQUE_LLWEAPONEX_Axe_1H_Throwable_A_Air_DisplayName	Balrin's Throwing Axe (Lightning)
WPN_UNIQUE_LLWEAPONEX_Axe_1H_Throwable_A_Fire_DisplayName	Balrin's Throwing Axe (Fire)
WPN_UNIQUE_LLWEAPONEX_Axe_1H_Throwable_A_Oil_DisplayName	Balrin's Throwing Axe (Oil)
WPN_UNIQUE_LLWEAPONEX_Axe_1H_Throwable_A_Water_DisplayName	Balrin's Throwing Axe (Ice)
WPN_UNIQUE_LLWEAPONEX_BattleBook_2H_Bible_B_DisplayName	Scripture of the Righteous
WPN_UNIQUE_LLWEAPONEX_BattleBook_2H_Spellbook_A_DisplayName	Talsim's Oversized Book of Spells
WPN_UNIQUE_LLWEAPONEX_BattleBook_2H_SpellScroll_A_DisplayName	Gnak's Spell Scroll
WPN_UNIQUE_LLWEAPONEX_Blunderbuss_2H_A_DisplayName	Eruption, Dwarven Blunderbuss
WPN_UNIQUE_LLWEAPONEX_Bokken_1H_A_DisplayName	Pacifist's Wrath (1H)
WPN_UNIQUE_LLWEAPONEX_Bokken_2H_A_DisplayName	Pacifist's Wrath (2H)
WPN_UNIQUE_LLWEAPONEX_DragonBoneClaws_A_DisplayName	Dragon Bone Claws
WPN_UNIQUE_LLWEAPONEX_DualShields_GiantDoor_A_DisplayName	Giant Door Greatshields
WPN_UNIQUE_LLWEAPONEX_DualShields_OrmaReeve_DisplayName	Orma and Reeve's Twin Greatshields
WPN_UNIQUE_LLWEAPONEX_Flamethrower_2H_A_DisplayName	Dragonblaze Flamethrower
WPN_UNIQUE_LLWEAPONEX_Greatbow_Lightning_A_DisplayName	Omnibolt, Heaven's Wrath
WPN_UNIQUE_LLWEAPONEX_Grimoire_Death_DisplayName	Torment, Book of the Dead
WPN_UNIQUE_LLWEAPONEX_Grimoire_Fire_DisplayName	Heretic's Almanac
WPN_UNIQUE_LLWEAPONEX_Grimoire_Magic_EternalSpark_DisplayName	<font color='#FE6E27'>The Eternal Spark</font>
WPN_UNIQUE_LLWEAPONEX_Grimoire_Mimicry_DisplayName	Imitation, Guide to Mimicry
WPN_UNIQUE_LLWEAPONEX_Grimoire_Swap_DisplayName	Gatekeeper's Codex
WPN_UNIQUE_LLWEAPONEX_Grimoire_Wind_DisplayName	Whispersong
WPN_UNIQUE_LLWEAPONEX_Gun_1H_VampireSlayer_A_Melee_DisplayName	Sanguinebane (Blade)
WPN_UNIQUE_LLWEAPONEX_Gun_1H_VampireSlayer_A_Ranged_DisplayName	Sanguinebane (Gun)
WPN_UNIQUE_LLWEAPONEX_Halberd_2H_Warchief_Axe_A_DisplayName	Warchief's Halberd
WPN_UNIQUE_LLWEAPONEX_Halberd_2H_Warchief_Spear_A_DisplayName	Warchief's Halberd
WPN_UNIQUE_LLWEAPONEX_Katana_2H_Muramasa_DisplayName	Muramasa, The Cursed Blade
WPN_UNIQUE_LLWEAPONEX_Katana_2H_Raizan_1_DisplayName	Raizan
WPN_UNIQUE_LLWEAPONEX_Katana_2H_Raizan_2_DisplayName	Raizan (Empowered)
WPN_UNIQUE_LLWEAPONEX_Katana_2H_Raizan_3_DisplayName	Raizan (Unleashed)
WPN_UNIQUE_LLWEAPONEX_Katana_Runeblade_Fire_1H_DisplayName	Kagutsuchi
ARM_UNIQUE_LLWEAPONEX_Pistol_A_Isshin_A_DisplayName	Flintlock of the Ashina
WPN_UNIQUE_LLWEAPONEX_Quarterstaff_PowerPole_DisplayName	Power Pole
WPN_UNIQUE_LLWEAPONEX_Rapier_Runeblade_Water_1H_DisplayName	Frostdyne
WPN_UNIQUE_LLWEAPONEX_Rapier_Runeblade_Water_1H_2_DisplayName	Frostdyne (Empowered)
WPN_UNIQUE_LLWEAPONEX_Rapier_Runeblade_Water_1H_3_DisplayName	Frostdyne (Unleashed)
WPN_UNIQUE_LLWEAPONEX_Rod_1H_MagicMissile_A_DisplayName	Scepter of Magic Missile
WPN_UNIQUE_LLWEAPONEX_Runeblade_ChaosEdge_2H_DisplayName	Chaos Edge
WPN_UNIQUE_LLWEAPONEX_Scythe_2H_DeathEdge_A_DisplayName	Death's Edge
WPN_UNIQUE_LLWEAPONEX_Scythe_2H_SoulHarvest_A_DisplayName	Soul Harvest
WPN_UNIQUE_LLWEAPONEX_Scythe_2H_BurialBlade_A_DisplayName	Burial Blade (Scythe)
WPN_UNIQUE_LLWEAPONEX_Sword_1H_BurialBlade_A_Mainhand_DisplayName	Burial Blade (Blade)
WPN_UNIQUE_LLWEAPONEX_Club_1H_BurialBlade_A_Offhand_DisplayName	Burial Blade (Offhand)
WPN_UNIQUE_LLWEAPONEX_Staff_Banner_DivineOrder_A_DisplayName	Banner of Unruly Faith
WPN_UNIQUE_LLWEAPONEX_Staff_Banner_Dwarves_A_DisplayName	Banner of the Pack
WPN_UNIQUE_LLWEAPONEX_Sword_2H_Beholder_A_DisplayName	Beholder
WPN_UNIQUE_LLWEAPONEX_Wand_1H_MagicMissile_A_DisplayName	Scepter of Magic Missile
WPN_UNIQUE_LLWEAPONEX_Wraithblade_2H_A_DisplayName	Wraithblade